50
40
1,1,1,1,1,1,1,1,1,1,1,1,1,1,1,1,1,1,1,1,1,1,1,1,1,1,1,1,1,1,1,1,1,1,1,1,1,1,1,1,1,1,1,1,1,1,1,1,1,1,
1,0,0,0,0,0,0,0,0,0,0,0,0,0,0,0,0,0,0,0,0,0,0,0,0,0,0,0,0,0,0,0,0,0,0,0,0,0,0,0,0,0,0,0,0,0,0,0,0,1,
1,0,0,0,0,0,0,0,0,0,0,0,0,0,0,0,0,0,0,0,0,0,0,0,0,0,0,0,0,0,0,0,0,0,0,0,0,0,0,0,0,0,0,0,0,0,0,0,0,1,
1,0,0,0,0,0,0,0,0,0,0,0,0,0,0,0,0,0,0,0,0,0,0,0,0,0,0,0,0,0,0,0,0,0,0,0,0,0,0,0,0,0,0,0,0,0,0,0,0,1,
1,0,0,0,0,0,0,0,0,0,0,0,0,0,0,0,0,0,0,0,0,0,0,0,0,0,0,0,0,0,0,0,0,0,0,0,0,0,0,0,0,0,0,0,0,0,0,0,0,1,
1,0,0,0,0,0,0,0,0,0,0,0,0,0,0,0,0,0,0,0,0,0,0,0,0,0,0,0,0,0,0,0,0,0,0,0,0,0,0,0,0,0,0,0,0,0,0,0,0,1,
1,0,0,0,0,0,0,0,0,0,0,0,0,0,0,0,0,0,0,0,0,0,0,0,0,0,0,0,0,0,0,0,0,0,0,0,0,0,0,0,0,0,0,0,0,0,0,0,0,1,
1,0,0,0,0,0,0,0,0,0,0,0,0,0,0,0,0,0,0,0,0,0,0,0,0,0,0,0,0,0,0,0,0,0,0,0,0,0,0,0,0,0,0,0,0,0,0,0,0,1,
1,0,0,0,0,0,0,0,0,0,0,0,0,0,0,0,0,0,0,0,0,0,0,0,0,0,0,0,0,0,0,0,0,0,0,0,0,0,0,0,0,0,0,0,0,0,0,0,0,1,
1,0,0,0,0,0,0,0,0,0,0,0,0,0,0,0,0,0,0,0,0,0,0,0,0,0,0,0,0,0,0,8,9,9,9,9,9,20,0,0,0,0,8,9,9,9,9,9,9,9,
1,0,0,0,0,0,0,0,0,0,0,0,0,0,0,0,0,0,0,0,0,0,0,0,0,0,0,0,0,0,0,12,1,1,1,1,5,17,0,0,0,0,12,1,1,1,1,1,1,1,
1,0,0,0,0,0,0,0,0,0,0,0,0,0,0,0,0,0,0,0,0,0,0,0,0,0,0,0,0,0,0,12,1,1,1,1,1,17,0,0,0,0,12,1,1,1,1,1,1,1,
1,0,0,0,0,0,0,0,0,0,0,0,0,0,0,0,0,0,0,0,0,0,0,0,0,0,0,0,0,0,230,12,1,1,1,1,1,17,370,371,371,372,12,1,1,1,1,1,1,1,
1,0,0,0,0,0,0,0,0,0,0,0,0,0,0,0,0,0,0,0,0,0,0,0,0,0,373,371,371,371,372,12,1,1,1,1,1,17,0,0,0,0,12,1,1,1,1,1,1,1,
1,0,0,0,0,0,0,0,0,0,0,0,0,0,0,0,0,0,0,0,0,0,0,0,0,0,377,0,0,0,196,12,1,1,1,1,1,17,0,0,0,0,12,1,1,1,1,1,1,1,
1,0,0,0,0,0,0,0,0,0,0,0,0,0,0,0,0,0,0,0,0,0,0,0,0,371,371,373,0,0,0,12,1,1,1,1,1,17,370,371,371,372,11,15,15,1,1,1,1,1,
1,0,0,0,0,0,0,0,0,0,0,0,0,0,0,0,0,0,0,0,0,0,0,0,0,0,0,377,0,0,191,12,1,1,1,1,1,17,0,0,0,0,0,0,0,12,1,1,1,1,
1,0,0,0,0,0,0,0,0,0,0,0,0,0,0,0,0,0,0,0,0,0,0,0,0,0,0,377,190,0,230,12,1,1,1,1,1,17,0,0,0,0,0,0,0,12,1,1,1,1,
1,0,0,0,0,0,0,0,0,0,0,0,0,0,0,0,0,0,0,0,0,0,371,372,8,9,9,9,9,9,9,10,1,1,1,1,1,17,370,371,371,373,0,0,0,12,1,1,1,1,
1,0,0,0,0,0,0,0,0,0,0,0,0,0,0,0,0,0,0,0,0,0,0,0,12,14,3,1,1,1,1,1,1,1,1,1,1,17,0,0,0,377,0,0,0,12,1,1,1,1,
1,0,0,0,0,0,0,0,0,0,0,0,0,0,0,0,0,0,0,0,0,0,0,196,11,15,15,61,61,61,3,1,1,1,1,1,1,17,0,0,0,8,9,20,372,12,1,1,1,1,
1,0,0,0,0,0,0,369,371,0,0,0,0,0,0,0,0,0,0,0,0,0,0,0,198,199,0,0,0,0,79,1,1,1,1,1,1,17,0,0,0,12,1,17,0,12,1,1,1,1,
1,0,0,0,0,0,0,378,0,0,0,0,0,0,0,0,0,0,0,0,0,0,0,0,0,0,0,0,202,0,79,1,1,1,1,1,1,17,0,0,0,12,1,17,0,12,1,1,1,1,
1,0,0,0,369,371,372,369,0,0,0,0,0,0,0,0,349,0,0,211,0,0,0,0,0,0,0,0,200,0,79,1,1,1,1,1,1,17,0,0,0,12,1,17,370,12,1,1,1,1,
1,0,0,0,378,0,0,378,0,0,0,0,0,0,369,371,371,371,373,370,0,0,0,0,0,0,0,0,0,0,79,1,1,1,1,1,1,17,0,0,0,11,15,18,0,12,1,1,1,1,
1,0,0,0,378,0,0,378,0,0,0,0,0,0,378,0,0,230,377,0,0,0,0,0,8,9,73,9,73,73,81,1,1,1,1,1,1,17,0,0,0,0,377,0,0,12,1,1,1,1,
9,9,9,9,9,9,9,9,9,9,20,370,371,371,371,371,371,371,373,0,0,0,0,0,12,5,1,1,1,1,1,1,1,1,1,1,1,17,0,0,0,0,377,0,0,12,1,1,1,1,
1,0,0,0,0,0,0,0,0,0,17,0,0,0,0,0,0,0,375,0,0,0,0,0,12,1,1,1,1,1,1,1,1,1,1,1,1,17,0,0,0,0,375,0,0,12,1,1,1,1,
1,0,0,0,0,0,0,0,0,0,17,0,0,0,0,0,0,0,375,8,9,9,9,9,10,1,1,1,1,1,1,1,1,1,1,1,1,17,0,0,0,0,375,0,0,12,1,1,1,1,
1,0,0,0,0,0,0,0,0,0,17,0,0,0,0,0,0,371,372,12,1,1,1,1,1,1,1,1,1,1,1,1,1,1,1,1,1,17,370,371,371,371,373,0,0,12,1,1,1,1,
1,0,0,0,0,0,0,0,0,0,17,0,0,0,0,0,0,0,0,11,15,15,15,15,15,15,15,15,15,15,15,15,15,15,15,15,15,18,0,0,0,0,377,0,0,12,1,1,1,1,
1,0,0,0,0,0,0,0,0,0,17,0,0,0,0,0,0,0,0,0,0,0,0,0,0,0,0,0,0,0,0,0,0,0,0,0,0,0,0,0,0,0,377,0,0,12,1,1,1,1,
1,0,0,0,0,0,0,0,0,0,17,0,0,0,0,0,0,0,0,0,0,0,0,0,0,0,0,0,0,0,0,0,0,0,0,0,0,0,0,0,0,0,375,0,0,11,15,1,1,1,
1,0,0,0,0,0,0,0,0,0,17,0,0,0,0,0,0,0,0,0,0,0,0,0,0,0,0,0,0,0,0,0,0,0,0,0,0,0,0,0,0,0,375,0,0,0,0,12,1,1,
1,0,0,0,0,0,0,0,0,0,17,0,0,0,0,0,0,0,0,0,0,0,0,0,0,0,0,0,0,0,0,0,0,0,0,0,0,0,0,0,0,0,375,0,0,0,0,12,1,1,
1,0,0,0,0,0,0,0,0,0,19,9,9,9,9,9,9,9,9,9,9,9,9,9,9,9,9,9,9,9,9,9,9,9,9,9,9,9,9,9,9,9,9,9,9,9,9,1,1,1,
1,0,0,0,0,0,0,0,0,0,0,0,0,0,0,0,0,0,0,0,0,0,0,0,0,0,0,0,0,0,0,0,0,0,0,0,0,0,0,0,0,0,0,0,0,0,0,1,1,1,
1,0,0,0,0,0,0,0,0,0,0,0,0,0,0,0,0,0,0,0,0,0,0,0,0,0,0,0,0,0,0,0,0,0,0,0,0,0,0,0,0,0,0,0,0,0,0,1,1,1,
1,0,0,0,0,0,0,0,0,0,0,0,0,0,0,0,0,0,0,0,0,0,0,0,0,0,0,0,0,0,0,0,0,0,0,0,0,0,0,0,0,0,0,0,0,0,0,1,1,1,
1,1,1,1,1,1,1,1,1,1,1,1,1,1,1,1,1,1,1,1,1,1,1,1,1,1,1,1,1,1,1,1,1,1,1,1,1,1,1,1,1,1,1,1,1,1,1,1,1,1,




md.torchDataVector.emplace_back(glm::ivec2{ 28, 22}, 48, 0, 0);
