20
20
0,0,0,0,0,0,0,0,0,57,62,62,62,66,0,0,0,0,0,0,
0,0,0,57,62,62,62,66,0,60,1,1,3,63,0,0,0,0,0,0,
0,0,0,59,61,61,61,64,0,59,61,61,61,64,0,0,0,0,0,0,
0,0,0,0,191,192,191,0,0,0,193,192,191,0,0,0,0,0,0,0,
0,0,0,0,0,192,0,0,0,0,0,192,0,0,0,0,0,0,0,0,
0,0,0,0,0,191,0,0,0,0,0,193,0,0,0,0,0,0,0,0,
0,0,0,0,0,201,0,0,0,0,0,201,0,0,0,0,0,0,0,0,
0,0,0,0,0,200,0,0,0,0,0,200,0,0,0,0,0,0,0,0,
0,0,0,0,0,194,0,0,0,0,0,194,0,0,0,0,0,0,0,0,
0,0,0,57,62,62,62,62,62,62,62,62,62,62,66,0,0,0,0,0,
0,0,0,60,1,7,1,1,1,1,6,1,1,1,63,0,0,0,0,0,
0,0,0,60,1,1,1,1,1,1,1,1,1,1,63,0,0,0,0,0,
0,0,0,59,61,61,61,61,61,61,61,61,61,61,64,0,0,0,0,0,
0,0,0,0,0,0,0,0,0,0,0,0,0,0,0,0,0,0,0,0,
0,0,0,0,0,0,0,0,0,0,0,0,0,0,0,0,0,0,0,0,
0,0,0,0,0,0,0,0,0,0,0,0,0,0,0,0,0,0,0,0,
0,0,0,0,0,0,0,0,0,0,0,0,0,0,0,0,0,0,0,0,
0,0,0,0,0,0,0,0,0,0,0,0,0,0,0,0,0,0,0,0,
0,0,0,0,0,0,0,0,0,0,0,0,0,0,0,0,0,0,0,0,
0,52428,52428,52428,52428,52428,52428,52428,52428,52428,52428,52428,52428,52428,52428,52428,52428,52428,52428,52428,






md.torchDataVector.emplace_back(glm::ivec2{ 11, 6}, 5, 5, 7);
md.torchDataVector.emplace_back(glm::ivec2{ 5, 6}, 5, 5, 7);
